# North America
VRM = "countries/Vermont.txt"
DIX = "countries/Dixie.txt"
NEG = "countries/NewEngland.txt"
CAL = "countries/California.txt"
YUC = "countries/Yucatan.txt"
PGN = "countries/Patagonia.txt"
URU = "countries/Uruguay.txt"
BLV = "countries/Bolivia.txt"
CUB = "countries/Cuba.txt"
TXS = "countries/Texas.txt"
CHS = "countries/Chesapeake.txt"
MRT = "countries/Maritimes.txt"
GCL = "countries/GranColombia.txt"
SAF = "countries/SouthAfrica.txt"
RGR = "countries/RioGrande.txt"
NFL = "countries/Newfoundland.txt"
AMZ = "countries/Amazonia.txt"
NZL = "countries/NewZealand.txt"
ALK = "countries/Alaska.txt"
GYA = "countries/Guyana.txt"
AZL = "countries/Aztlan.txt"
ILN = "countries/Illinois.txt"
CSC = "countries/Columbia.txt"
ACD = "countries/Acadia.txt"
WFL = "countries/WestFlorida.txt"
PEI = "countries/PEI.txt"
ECU = "countries/Ecuador.txt"
PBC = "countries/PeruBolivia.txt"
DOM = "countries/DominicanRepublic.txt"
RGS = "countries/RioGrandeDoSol.txt"
ATC = "countries/AntilleanConfederation.txt"
CTR = "countries/CostaRica.txt"
NRG = "countries/Nicraragua.txt"
ELS = "countries/ElSalvador.txt"
HND = "countries/Honduras.txt"
GTL = "countries/Guatemala.txt"
